TTGCTGCGTTTATATTATCGTCGTGCTATGTACATACATTCACAAATGTATGTAAATCTAACGCCTGTAAATTCACGAACATATGGCACGAAAAACCAAACAAGAAGCGCAAGAAACGCGCCAACACATCCTCGATGTGGCTCTACGTCTTTTCTCACAGCAGGGGGTATCATCCACCTCGCTGGGCGAGATTGCAAAAGCAGCTGGCGTTACGCGCGGTGCAATCTACTGGCATTTTAAAG	TTGCTGCGTTTATATTATCGTCGTGCTATGGTACATACATTCACAAATGTATGTAAATCTAACGCCTGTAAATTCACGAACATATGGCACGAAAAACCAAACAAGAAGCGCAAGAAACGCGCCAACACATCCTCGATGTGGCTCTACGTCTTTTCTCACAGCAGGGGGTATCATCCACCTCGCTGGGCGAGATTGCAAAAGCAGCTGGCGTTACGCGCGGTGCAATCTACTGGCATTTTAAAG
AATTGGTCAATGGTCAAAAGTTAATAAACCATTGCTGCGTTTATATTATCGTCGTGCTATGGTACATACATTCACAAATGTATGTAAATCTAACGCCTGTAAATTCACGAACATATGGACACGAAAAACCAAACAAGAAGCGCAAGAAAACGCGCCAACACATCCATCGATGTGGCTC	AATTGGTCAATGGTCAAAAGTTAATAAACCCATTGCTGCGTTTATATTATCGTCGTGCTATGGTACATACATTCACAAATGTATGTAAATCTAACGCCTGTAAATTCACGAACATATGGCACGAAAAACCAAACAAGAAGCGCAAGAAACGCGCCAACACATCCTCGATGTGGCTC
CCGCCAGAGGCGTAAACCCTCTGTTTTGTTCATATGTAAACCTCGAGTGTCCGATTTCAAATTGGTCAATGGTCAAAAGTTAATAAACCCATTGCTGCGTTTATATTATCGTCGTGCTATGGTACATACATTCACAAATGTATGTAAATCTAACGCCTGTAAATTCACGAACATATGGCACGAAAAACCAAACAAGAAGCGCAAGAAACGCGCCAACACATCCTCGATGTG	CCGCCAGAGGCGTAAACCCTCTGTTTTTGTTCATATGTAAACCTCGAGTGTCCGATTTCAAATTGGTCAATGGTCAAAAGTTAATAAACCCATTGCTGCGTTTATATTATCGTCGTGCTATGGTACATACATTCACAAATGTATGTAAATCTAACGCCTGTAAATTCACGAACATATGGCACGAAAAACCAAACAAGAAGCGCAAGAAACGCGCCAACACATCCTCGATGTG
CGCCAGAGGCGTAAACCCATCTGTTTTTGTTCATATGTAAACCTCGAGTGTCCGATTTCAAATTGGTCAATGGTCAAAAGTTAATAAACCCATTGCTGCGTTTATATTATCGTCGTGCTATGGTACATACATTCACAAATGTATGTAAATCTAACGCCTGTAAATTCACGAACATATGGCACGAAAAACCAAACAAGAAGCGCAAGAAACGCGCCAACACATCCTCGATGTGG	CGCCAGAGGCGTAAACCCTCTGTTTTTGTTCATATGTAAACCTCGAGTGTCCGATTTCAAATTGGTCAATGGTCAAAAGTTAATAAACCCATTGCTGCGTTTATATTATCGTCGTGCTATGGTACATACATTCACAAATGTATGTAAATCTAACGCCTGTAAATTCACGAACATATGGCACGAAAAACCAAACAAGAAGCGCAAGAAACGCGCCAACACATCCTCGATGTGG
AATTGGTCAATGGTCAAAAGTTAATAAACCATTGCTGCGTTTATATTATCGTCGTGCTATGGTACATACATTCACAAATGTATGTAAATCTAACGCCTGTAAATTCACGAACATATGGCACGAAAAACCAAACAAGAAGCGCAAGAAAACGCGCCAACACATCCTCGATAGTGGCTCTACGTCTTTTCTCACAGCAGGGG	AATTGGTCAATGGTCAAAAGTTAATAAACCCATTGCTGCGTTTATATTATCGTCGTGCTATGGTACATACATTCACAAATGTATGTAAATCTAACGCCTGTAAATTCACGAACATATGGCACGAAAAACCAAACAAGAAGCGCAAGAAACGCGCCAACACATCCTCGATGTGGCTCTACGTCTTTTCTCACAGCAGGGG
AATGGTCAAAAAGTTAATAAACCATTGCTGCGTTTATATTATCGTCGTGCTATGGTACATACATTCACAAATGTATGTAAATCTAACGCCTGTAAATTCACGAACATATGGCACGAAAAACCAAAACAAGAAGCGCAAGAAAACGCGCCAACACATCCTCGATGTGGCTCTACGTTCTTTTCTCACAGCAGGGGGGACTTCATCCACCATCGCTGGGCGAGATTGCAAAAGCAGCTGGCGTTACGCGCG	AATGGTCAAAAGTTAATAAACCCATTGCTGCGTTTATATTATCGTCGTGCTATGGTACATACATTCACAAATGTATGTAAATCTAACGCCTGTAAATTCACGAACATATGGCACGAAAAACCAAACAAGAAGCGCAAGAAACGCGCCAACACATCCTCGATGTGGCTCTACGTCTTTTCTCACAGCAGGGGGTATCATCCACCTCGCTGGGCGAGATTGCAAAAGCAGCTGGCGTTACGCGCG
TGTCCGATTTCAAATTGGTCAAATGGTCAAAAGTTAATAAACCCATTGCTGCGTTTATATTATCGTCGTGCTATGGTACATACATTCACAAATGTATGTAAATCTAACGCCTGTAAATTCACGAACATATGGCACGAAAAACCAAACAAGAAGCGCAAGAAACGCGCCAACACATCCTCGATGTGGCTCTACGTCTTTTCTCACAGCAGGGGGTATCATCCACCTCGCTGGGCGAGATTGCAAAAGCAGCTGGCGTTACG	TGTCCGATTTCAAATTGGTCAATGGTCAAAAGTTAATAAACCCATTGCTGCGTTTATATTATCGTCGTGCTATGGTACATACATTCACAAATGTATGTAAATCTAACGCCTGTAAATTCACGAACATATGGCACGAAAAACCAAACAAGAAGCGCAAGAAACGCGCCAACACATCCTCGATGTGGCTCTACGTCTTTTCTCACAGCAGGGGGTATCATCCACCTCGCTGGGCGAGATTGCAAAAGCAGCTGGCGTTACG
GCTGCGTTTATATTATCGTCGTGCTATGGTTACATACATTCACAAATGTATGTAATACTAACGCCTGTAAATTCACGAACATATGGCACGAAAAACCAAACAAGAAGCGCAAGAAACGCGCCAACACATCCTCGATGTGGCTCTACGTCTTTTCTCACAGCAGGGGGTATCATCCACCTCGCTGGGCGAGATTGCAAAAGCA	GCTGCGTTTATATTATCGTCGTGCTATGGTACATACATTCACAAATGTATGTAAATCTAACGCCTGTAAATTCACGAACATATGGCACGAAAAACCAAACAAGAAGCGCAAGAAACGCGCCAACACATCCTCGATGTGGCTCTACGTCTTTTCTCACAGCAGGGGGTATCATCCACCTCGCTGGGCGAGATTGCAAAAGCA
CTGTTTTTTGTTCATATGTAAACCTCGAGTGTCCGATTTCAAATTGGTCAATGGTCAAAAGTTAATAAACCCATTGCTGCGTTTATATTATCGTCGTGCTATGGTACATACATTCACAAATGTATGTAAATCTAACGCCTGTAAATTCACGAACATATGGCACGAAAAACCAAACAAGAAGCGCAAGAAACGACGCCAACAACATCCTCCGATAGTGGCTCTACGTCTTTTCTCACAGCAGGGG	CTGTTTTTGTTCATATGTAAACCTCGAGTGTCCGATTTCAAATTGGTCAATGGTCAAAAGTTAATAAACCCATTGCTGCGTTTATATTATCGTCGTGCTATGGTACATACATTCACAAATGTATGTAAATCTAACGCCTGTAAATTCACGAACATATGGCACGAAAAACCAAACAAGAAGCGCAAGAAACGCGCCAACACATCCTCGATGTGGCTCTACGTCTTTTCTCACAGCAGGGG
CGTTTATATTATCGTCGTGCTATGGTACATTCCAATTACACAATGTAATGTAAATACACGCCTGTAAATCAACAACAGTGGCAACGAAAAACCAAACAACGAAGCAGCAAGAAACGCGCCAACACATCCTCGATGTGGCTCTACGTCTTTTCTCACAGCAGGGGGTATCATCCACCTCGCTGGGCGAGATTGCAAAAGCAGCTGGCGTTACGCGCGGTGCAATCTACTGGCATTT	CGTTTATATTATCGTCGTGCTATGGTACATACATTCACAAATGTATGTAAATCTAACGCCTGTAAATTCACGAACATATGGCACGAAAAACCAAACAAGAAGCGCAAGAAACGCGCCAACACATCCTCGATGTGGCTCTACGTCTTTTCTCACAGCAGGGGGTATCATCCACCTCGCTGGGCGAGATTGCAAAAGCAGCTGGCGTTACGCGCGGTGCAATCTACTGGCATTT
TGTTCATATGTAAAACGTCGAGTGTCCGATTTTCAAATTGGTCAATGGTCAAAAGTTAATAAACCCATTGCTCGTTTATATTTATCGTCGTGCTATGGTACATACATTCACAAATGTATGTAAATCTAAACGCCTGTAAATTCACGAACATATGGCACGAAAAACCAAACAAAGAAGCGCAAGAAACGCGCCAACACATCCTCGATGTGGCTCTACGTCTTTTCTCACAGCAGGGGGG	TGTTCATATGTAAACCTCGAGTGTCCGATTTCAAATTGGTCAATGGTCAAAAGTTAATAAACCCATTGCTGCGTTTATATTATCGTCGTGCTATGGTACATACATTCACAAATGTATGTAAATCTAACGCCTGTAAATTCACGAACATATGGCACGAAAAACCAAACAAGAAGCGCAAGAAACGCGCCAACACATCCTCGATGTGGCTCTACGTCTTTTCTCACAGCAGGGGGT
AATTGGTCAATGGTCAAAAGTTAATAAACCATTGCTGCGTTTATATTATCGTCGTGCTATGGTACATACATTCACAAATGTATGTAAATCTAACGCCTGTAAATTCACGAACATATGGCACGAAAAACCAAACAAGAAGCGCAAGAAAACGCGCCAACACATCCTCGATAGTGGCTCTACGTCTTTTCTCACAGCAGGGG	AATTGGTCAATGGTCAAAAGTTAATAAACCCATTGCTGCGTTTATATTATCGTCGTGCTATGGTACATACATTCACAAATGTATGTAAATCTAACGCCTGTAAATTCACGAACATATGGCACGAAAAACCAAACAAGAAGCGCAAGAAACGCGCCAACACATCCTCGATGTGGCTCTACGTCTTTTCTCACAGCAGGGG
TTTTTTGTTCATATGTAAAACCTCGAGTGTCCGATTTCAAATTGGTCAATGGTCAAAAGTTAATAAAACCCATTGCTGCGTTTATATTATCGTCGTGCTATGGTACATACATTCACAAATGTATGTAAATCTAACGCCTGTAAATTCACGAACA	GTTTTTGTTCATATGTAAACCTCGAGTGTCCGATTTCAAATTGGTCAATGGTCAAAAGTTAATAAACCCATTGCTGCGTTTATATTATCGTCGTGCTATGGTACATACATTCACAAATGTATGTAAATCTAACGCCTGTAAATTCACGAACA
AATTGGTCAATGGTCAAAAGTTAATAAACCATTGCTGCGTTTATATTATCGTCGTGCTATGGTACATACATTCACAAATGTATGTAAATCTAACGCCTGTAAATTCACGAACATATGGCACGAAAAAACCAAACAAGAAGCGCAAGAAAACGCGCCAACACATCCTCGAATGTGGCTCTACGTCTTTTCTCACAGCAGGGGTAGTCATCCACCTCGCTGGGCGAGATTGACAAAAGC	AATTGGTCAATGGTCAAAAGTTAATAAACCCATTGCTGCGTTTATATTATCGTCGTGCTATGGTACATACATTCACAAATGTATGTAAATCTAACGCCTGTAAATTCACGAACATATGGCACGAAAAACCAAACAAGAAGCGCAAGAAACGCGCCAACACATCCTCGATGTGGCTCTACGTCTTTTCTCACAGCAGGGGGTATCATCCACCTCGCTGGGCGAGATTGCAAAAGC
CGTAAACCCACTGTTTTTGTTCATATGTAAATCCTCGAGTGTCCGATTTCAAATTGGTCAATGGTCAAAAGTTAATAAACCCATTGCTGCGTTTATATTATCGTCGTGCTATGGTACATACATTCACAAATGTATGTAAATCTAACGCCTGTAAATTCACGAACATATGGCACGAAAAACCAAACAAGAAGCGCAAGAAACGCGCCAACACATCCTCGATGTGGCTCTACGTCTTTTCTCA	CGTAAACCCTCTGTTTTTGTTCATATGTAAACCTCGAGTGTCCGATTTCAAATTGGTCAATGGTCAAAAGTTAATAAACCCATTGCTGCGTTTATATTATCGTCGTGCTATGGTACATACATTCACAAATGTATGTAAATCTAACGCCTGTAAATTCACGAACATATGGCACGAAAAACCAAACAAGAAGCGCAAGAAACGCGCCAACACATCCTCGATGTGGCTCTACGTCTTTTCTCA
GCTGCGTTTATATTATCGTCGTGCTATGGTTACATACATTCACAAATGTAATGTAAATCTAACGCCTGTAAATTCAACGAACATATGGCAACGAAAAACCAAACAAGAAGCAGCAAGAAACGCGCCAACACATCCTCGATGTGGCTCTACGTCTTTTCTCACAGCAGGGGGTATCATCCACCTCGCTGGGCGAGATTGCAAAAGCAGCTGGCGTTACGCGCG	GCTGCGTTTATATTATCGTCGTGCTATGGTACATACATTCACAAATGTATGTAAATCTAACGCCTGTAAATTCACGAACATATGGCACGAAAAACCAAACAAGAAGCGCAAGAAACGCGCCAACACATCCTCGATGTGGCTCTACGTCTTTTCTCACAGCAGGGGGTATCATCCACCTCGCTGGGCGAGATTGCAAAAGCAGCTGGCGTTACGCGCG
CCTCTGTTTTTGTTCATATGTAAACCTCGAAGTGTCCGATTTCAAATTGGTCAATGGTCAAAAGTTAATAAACCCATTGCTGCGTTTATATTATCGTCGTGCTATGGTACATACATTCACAAATGTATGTAAATCTAACGCCTGTAAATTCACGAACATATGGCACGAAAAAACCAAACAAGAAGCGCAAGAAACGCGCCAACACATCCTCGATGT	CCTCTGTTTTTGTTCATATGTAAACCTCGAGTGTCCGATTTCAAATTGGTCAATGGTCAAAAGTTAATAAACCCATTGCTGCGTTTATATTATCGTCGTGCTATGGTACATACATTCACAAATGTATGTAAATCTAACGCCTGTAAATTCACGAACATATGGCACGAAAAACCAAACAAGAAGCGCAAGAAACGCGCCAACACATCCTCGATGT
CACGAAAAACCAAACAAGAAGCGCAAGAAAACGCGCCAACACATCCTCGATGTGGCTCTACGTCTTTTCTCACAGCAGGGGGTATCATCCACCTCGCAGGGCGTAGATTGCAAAAGCAGCTGGCGTTACGCGCGGTGCAATCTACTGGCATTT	CACGAAAAACCAAACAAGAAGCGCAAGAAACGCGCCAACACATCCTCGATGTGGCTCTACGTCTTTTCTCACAGCAGGGGGTATCATCCACCTCGCTGGGCGAGATTGCAAAAGCAGCTGGCGTTACGCGCGGTGCAATCTACTGGCATTT
AATGGTCAAAAGTTAATAAACCATTGCTGCGTTTATATTATCGTCGTGCTATGGTACATACATTCACAAATGTATGTAAATCTAACGCCTGTAAATTCACGAACATATGGCACGAAAAACCAAACAAGAAGCGCAAGAAAACGCGCCAACACATCCTCGAATGTGGCTCTACGTCTTTTCTCACAGCAGGGGGTATCATCCACCTCGCTGGGCGAGATTGCAAAAGGCAGCTGGCGTTACG	AATGGTCAAAAGTTAATAAACCCATTGCTGCGTTTATATTATCGTCGTGCTATGGTACATACATTCACAAATGTATGTAAATCTAACGCCTGTAAATTCACGAACATATGGCACGAAAAACCAAACAAGAAGCGCAAGAAACGCGCCAACACATCCTCGATGTGGCTCTACGTCTTTTCTCACAGCAGGGGGTATCATCCACCTCGCTGGGCGAGATTGCAAAAGCAGCTGGCGTTACG
CACGAAAAACCAAACAAGAAGCGCAAGAAAACGCGCCAAACACATCCTCGAATGTGGCTCTACGTCTTTTCTCACAGCAGGGGGTACTCATCCACCTCGCTGGGCGAGATTGCAAAAGCAGCTGGCGTTACGCGCGGTGCAATCTACGTGGCATTTTAAAG	CACGAAAAACCAAACAAGAAGCGCAAGAAACGCGCCAACACATCCTCGATGTGGCTCTACGTCTTTTCTCACAGCAGGGGGTATCATCCACCTCGCTGGGCGAGATTGCAAAAGCAGCTGGCGTTACGCGCGGTGCAATCTACTGGCATTTTAAAG
CACGAAAAACCAAACAAGAAGCGCAAGAAAACGCGCCAAACACATCCTCGATGTGGCTCTACGTCTTTTCTCACAGCAGGGGGTATCATCCACCTCGCTGGGCGAGATTGCAAAAGCAGCTGGCGTTACGCGCGGTGCAATCTACTGGCATTTTAAAGACAAGTCGG	CACGAAAAACCAAACAAGAAGCGCAAGAAACGCGCCAACACATCCTCGATGTGGCTCTACGTCTTTTCTCACAGCAGGGGGTATCATCCACCTCGCTGGGCGAGATTGCAAAAGCAGCTGGCGTTACGCGCGGTGCAATCTACTGGCATTTTAAAGACAAGTCGG
TGTCCGATTTCAAATTGGTCAATGGTCAAAGTTAATAAACCATTGCTGCGTTTATATTATCGTCGTGCTATGGTACATACATTCACAAATGTATGTAAATCTAACGCCTGTAAATTCACGAACATATGGCACGAAAAAACCAAACAAGAAGCGCAAGAAACGCGCCAACACATCCTCGATGTGGCTCTACGTCTTTTCCTCACAGCCAGGGGGTATCATCCACCTCGCTGG	TGTCCGATTTCAAATTGGTCAATGGTCAAAAGTTAATAAACCCATTGCTGCGTTTATATTATCGTCGTGCTATGGTACATACATTCACAAATGTATGTAAATCTAACGCCTGTAAATTCACGAACATATGGCACGAAAAACCAAACAAGAAGCGCAAGAAACGCGCCAACACATCCTCGATGTGGCTCTACGTCTTTTCTCACAGCAGGGGGTATCATCCACCTCGCTGG
CATTGCTGCGTTATATTATCGTCGTGCTATGGTACATACATCACAAATGTATGTAAATCTAACGCCTGTAAATTCACGAACATATGGCACGAAAAACCAACAAGAAGCGCAAGAAACGCGCCAACACATCCTCGATGTGGCTCTACGTCTTTTCTCACAGCAGGGGGTATCATCCACCTCGCTGGGCGAGATTGCAAAAGCAGCTGGCGTTACGCGCGGTGCAATCTACTGGCATTTTAAAGACAAG	CATTGCTGCGTTTATATTATCGTCGTGCTATGGTACATACATTCACAAATGTATGTAAATCTAACGCCTGTAAATTCACGAACATATGGCACGAAAAACCAAACAAGAAGCGCAAGAAACGCGCCAACACATCCTCGATGTGGCTCTACGTCTTTTCTCACAGCAGGGGGTATCATCCACCTCGCTGGGCGAGATTGCAAAAGCAGCTGGCGTTACGCGCGGTGCAATCTACTGGCATTTTAAAGACAAG
TAAACCTCGAGTGTCCGAATTTCAAATTGGTCAATGGTCAAAAGTTAATAAACCCATTGCTGCGTTTATATTATCGTCGTGCTATGGTACATACATTCACAATGTAATGTAAATACTAACGCCTGTAAATTCAACGAACATATGCACGAAAAACCAAACAAAGAAGCGCAAGAAAACGCGCCAACACATCCTCGATGTGGCTCTACGTCTTTTCTCACAGCAGGGGGGT	TAAACCTCGAGTGTCCGATTTCAAATTGGTCAATGGTCAAAAGTTAATAAACCCATTGCTGCGTTTATATTATCGTCGTGCTATGGTACATACATTCACAAATGTATGTAAATCTAACGCCTGTAAATTCACGAACATATGGCACGAAAAACCAAACAAGAAGCGCAAGAAACGCGCCAACACATCCTCGATGTGGCTCTACGTCTTTTCTCACAGCAGGGGGTA
GCTATGGTACATACATTCACAAATGTATGTTAAATACTAACGCCTGTAAATTCAACGAACATATGGCACGAAAAACCAAACAAGAAAGCGCAAGAAACAGCGCCAACACATCCTCGATGTGGCTCTACGTCTTTTCTCACAGCAGGGGGTATCATCCACCTCGCTGGGCGAGATTGCAAAAGCAGCTGGCGTTACGCGCGGTGCAATCTACTGGCATTTTAAAGACA	GCTATGGTACATACATTCACAAATGTATGTAAATCTAACGCCTGTAAATTCACGAACATATGGCACGAAAAACCAAACAAGAAGCGCAAGAAACGCGCCAACACATCCTCGATGTGGCTCTACGTCTTTTCTCACAGCAGGGGGTATCATCCACCTCGCTGGGCGAGATTGCAAAAGCAGCTGGCGTTACGCGCGGTGCAATCTACTGGCATTTTAAAGACA
AATTGGTCAATGGTCAAAAGTTAATAAACCATTGCTGCGTTTATATTATCGTCGTGCTATGGTACATACATTCACAAATGTATGTAAATCTAACGCCTGTAAATTCACGAACATATGGCACGAAAAACCAAACAAGAAGCGCAAGAAACGCGCCAACACATCCTCGATGTGGCTCTACGTCTTTTCTCACAGCAGGGGGTATCATCCACCTCGCTGGGCGAGATTGCAAAAGCAGCTGGCGTTA	AATTGGTCAATGGTCAAAAGTTAATAAACCCATTGCTGCGTTTATATTATCGTCGTGCTATGGTACATACATTCACAAATGTATGTAAATCTAACGCCTGTAAATTCACGAACATATGGCACGAAAAACCAAACAAGAAGCGCAAGAAACGCGCCAACACATCCTCGATGTGGCTCTACGTCTTTTCTCACAGCAGGGGGTATCATCCACCTCGCTGGGCGAGATTGCAAAAGCAGCTGGCGTTA
CCGCCAGAGGCGTAAACCCTCTGTTTTGTTCATATGTAAACCTCGAGTGTCCGATTTCAAATTGGTCAATGGTCAAAAGTTAATAAACCCATTGCTGCGTTTATATTATCGTCGTGCTATGGTACATACATTCACAAATGTATGTAAATCTAACGCCTGTAAATTCACGAACATATGGCACGAAAAACCAAACAAGAAGCGCAAGAAACGCGCCAACACATCCTCGATGTG	CCGCCAGAGGCGTAAACCCTCTGTTTTTGTTCATATGTAAACCTCGAGTGTCCGATTTCAAATTGGTCAATGGTCAAAAGTTAATAAACCCATTGCTGCGTTTATATTATCGTCGTGCTATGGTACATACATTCACAAATGTATGTAAATCTAACGCCTGTAAATTCACGAACATATGGCACGAAAAACCAAACAAGAAGCGCAAGAAACGCGCCAACACATCCTCGATGTG
GCTATGGTACATACATTCACAAATGTATGTTAAATACTAACGCCTGTAAATTCAACGAACATATGGCACGAAAAACCAAACAAGAAAGCGCAAGAAACAGCGCCAACACATCCTCGATGTGGCTCTACGTCTTTTCTCACAGCAGGGGGTATCATCCACCTCGCTGGGCGAGATTGCAAAAGCAGCTGGCGTTACGCGCGGTGCAATCTACTGGCATTTTAAAGACA	GCTATGGTACATACATTCACAAATGTATGTAAATCTAACGCCTGTAAATTCACGAACATATGGCACGAAAAACCAAACAAGAAGCGCAAGAAACGCGCCAACACATCCTCGATGTGGCTCTACGTCTTTTCTCACAGCAGGGGGTATCATCCACCTCGCTGGGCGAGATTGCAAAAGCAGCTGGCGTTACGCGCGGTGCAATCTACTGGCATTTTAAAGACA
AATTGGTCAATGGTCAAAAGTTAATAAACCATTGCTGCGTTTATATTATCGTCGTGCTATGGTACATACATTCACAAATGTATGTAAATCTAACGCCTGTAAATTCACGAACATATGGCACGAAAAACCAAACAAGAAGCGCAAGAAACGCGCCAACACATCCTCGATGTGGCTCTACGTCTTTTCTCACAGCAGGGGGTATCATCCACCTCGCTGGGCGAGATTGCAAAAGCAGCTGGCGTTA	AATTGGTCAATGGTCAAAAGTTAATAAACCCATTGCTGCGTTTATATTATCGTCGTGCTATGGTACATACATTCACAAATGTATGTAAATCTAACGCCTGTAAATTCACGAACATATGGCACGAAAAACCAAACAAGAAGCGCAAGAAACGCGCCAACACATCCTCGATGTGGCTCTACGTCTTTTCTCACAGCAGGGGGTATCATCCACCTCGCTGGGCGAGATTGCAAAAGCAGCTGGCGTTA
AATTGGTCAATGGTCAAAAGTTAATAAACCATTGCTGCGTTTATATTATCGTCGTGCTATGGTACATACATTCACAAATGTATGTAAATCTAACGCCTGTAAATTCACGAACATATGGACACGAAAAACCAAACAAGAAGCGCAAGAAAACGCGCCAACACATCCTCGATGTGGCTCTCACGGTCTTTTCTTCACAGCAGGGGGTATCGATCCACTTCGCAGGGCGTAGATTGCAAAAGC	AATTGGTCAATGGTCAAAAGTTAATAAACCCATTGCTGCGTTTATATTATCGTCGTGCTATGGTACATACATTCACAAATGTATGTAAATCTAACGCCTGTAAATTCACGAACATATGGCACGAAAAACCAAACAAGAAGCGCAAGAAACGCGCCAACACATCCTCGATGTGGCTCTACGTCTTTTCTCACAGCAGGGGGTATCATCCACCTCGCTGGGCGAGATTGCAAAAGC
AGTTAATAAACCCATTGCTGCGTTTATATTTATCGTCGTGTCTATGGTACATACATTCACAAATGTATGTAAATCTAACGCCTGTAAATTCACGAACATATGGCACGAAAAACCAAACAAGAAGCGCAAGAAACGCGCCAACACATCCTCGATGTGGCTCTACGTCTTTTCTCACAGCAGGGG	AGTTAATAAACCCATTGCTGCGTTTATATTATCGTCGTGCTATGGTACATACATTCACAAATGTATGTAAATCTAACGCCTGTAAATTCACGAACATATGGCACGAAAAACCAAACAAGAAGCGCAAGAAACGCGCCAACACATCCTCGATGTGGCTCTACGTCTTTTCTCACAGCAGGGG
CACGAAAAACCAAACAAGAAGCGCAAGAAAACGCGCCAAACACATCCTCGAATGTGGCTCTACGTCTTTTCTCACAGCAGGGGGTACTCATCCACCTCGCTGGGCGAGATTGCAAAAGCAGCTGGCGTTACGCGCGGTGCAATCTACGTGGCATTTTAAAG	CACGAAAAACCAAACAAGAAGCGCAAGAAACGCGCCAACACATCCTCGATGTGGCTCTACGTCTTTTCTCACAGCAGGGGGTATCATCCACCTCGCTGGGCGAGATTGCAAAAGCAGCTGGCGTTACGCGCGGTGCAATCTACTGGCATTTTAAAG
GTAAATCTAACGCCTGTAAATTCACGAACAGTATGGACACGAAAAACCAAACAAGAAGCGCAAGAAACGCGCCAACACATCCTCGAATGGTGCCTCTTACGTCTTTTCTCACAGCAGGGGGACTCATCCACCTCGCTGGGCGAGATTGCAAAAGCA	GTAAATCTAACGCCTGTAAATTCACGAACATATGGCACGAAAAACCAAACAAGAAGCGCAAGAAACGCGCCAACACATCCTCGATGTGGCTCTACGTCTTTTCTCACAGCAGGGGGTATCATCCACCTCGCTGGGCGAGATTGCAAAAGCA
TGGTACATACATTCACAAATGTATGTAAATACTAACGCCTGTAATTCAACGAACATATGGCACGAAAAACCAAACAGAAAGCGCAAGAGACGCGCCAACACATCCTCGATGTGGCTCTACGTCTTTTCTCACAGCAGGGGGTATCATCCACCTCGCTGGGCGAGATTGCAAAAGCAGCTGGCGTTACGCGCGGTGC	TGGTACATACATTCACAAATGTATGTAAATCTAACGCCTGTAAATTCACGAACATATGGCACGAAAAACCAAACAAGAAGCGCAAGAAACGCGCCAACACATCCTCGATGTGGCTCTACGTCTTTTCTCACAGCAGGGGGTATCATCCACCTCGCTGGGCGAGATTGCAAAAGCAGCTGGCGTTACGCGCGGTGC
CACAAATGTATGTAAATCTAACGCCTGTAATTCAACGAACATATGGCACGAAAAACCAAACAAGAAGCGCAAGAAACGCGCCAACACATCCTCGATGTGGCTCTACGTCTTTTCTCACAGCAGGGGGTATCATCCACCTCGCTGGGCGAGATTGCAAAAGCAGCTG	CACAAATGTATGTAAATCTAACGCCTGTAAATTCACGAACATATGGCACGAAAAACCAAACAAGAAGCGCAAGAAACGCGCCAACACATCCTCGATGTGGCTCTACGTCTTTTCTCACAGCAGGGGGTATCATCCACCTCGCTGGGCGAGATTGCAAAAGCAGCTG
TATGGTACATACATTCACAAATGTATGTAATACTACGACTCGTAAATTCACGAACATATGGCACGAAAAAACCAACAAGAAGCGCAAAGAAACGCGCCAAACACATCCTCGATGTGCTCTACGTTCTTTCTCACAGCAGGGGGTATCATCACCTCGCTGGGCGAGATTGCAAAAGCAGCTGGCGTTACGCGCGTGCAATTCTACTGGCATTTAAAGACAAGT	TATGGTACATACATTCACAAATGTATGTAAATCTAACGCCTGTAAATTCACGAACATATGGCACGAAAAACCAAACAAGAAGCGCAAGAAACGCGCCAACACATCCTCGATGTGGCTCTACGTCTTTTCTCACAGCAGGGGGTATCATCCACCTCGCTGGGCGAGATTGCAAAAGCAGCTGGCGTTACGCGCGGTGCAATCTACTGGCATTTTAAAGACAAGT
AATTGGTCAATGGTCAAAAGTTAATAAACCGTTGCTGCGTTTATATTATCGTCGTGCTATGGTACATACATTCACAAATGTATGTAAATCTAACGCCTGTAAATTCACGAAACAATAATGGACCACAGAAAAAACCAAACAAGAAGCGCCAAGAAAACGCGCCAACACATCCTCGATGTGGCTCTA	AATTGGTCAATGGTCAAAAGTTAATAAACCCATTGCTGCGTTTATATTATCGTCGTGCTATGGTACATACATTCACAAATGTATGTAAATCTAACGCCTGTAAATTCACGAACATATGGCACGAAAAACCAAACAAGAAGCGCAAGAAACGCGCCAACACATCCTCGATGTGGCTCTA
TGGTCAAAAGTTAATAAACCCATTGCTGCGGTTTATATTTATCGTCGTGCTATGGTACATACATTCACAAATGTATGTAAATCTAACGCCTGTAAATTCACGAACATATGGCACGAAAAACCAAACAAAGAAGCGCAAGAAACGCGCCAACACATCCTCGATGTGGCTCTACGTCTTTTCTCACAGCAGG	TGGTCAAAAGTTAATAAACCCATTGCTGCGTTTATATTATCGTCGTGCTATGGTACATACATTCACAAATGTATGTAAATCTAACGCCTGTAAATTCACGAACATATGGCACGAAAAACCAAACAAGAAGCGCAAGAAACGCGCCAACACATCCTCGATGTGGCTCTACGTCTTTTCTCACAGCAGG
CGTTTATATTATCGTCGTGCTATGGTACATTCCAATTACACAATGTAATGTAAATACACGCCTGTAAATCAACAACAGTGGCAACGAAAAACCAAACAACGAAGCAGCAAGAAACGCGCCAACACATCCTCGATGTGGCTCTACGTCTTTTCTCACAGCAGGGGGTATCATCCACCTCGCTGGGCGAGATTGCAAAAGCAGCTGGCGTTACGCGCGGTGCAATCTACTGGCATTT	CGTTTATATTATCGTCGTGCTATGGTACATACATTCACAAATGTATGTAAATCTAACGCCTGTAAATTCACGAACATATGGCACGAAAAACCAAACAAGAAGCGCAAGAAACGCGCCAACACATCCTCGATGTGGCTCTACGTCTTTTCTCACAGCAGGGGGTATCATCCACCTCGCTGGGCGAGATTGCAAAAGCAGCTGGCGTTACGCGCGGTGCAATCTACTGGCATTT
CCGCCAGAGGCGTAAACCCTCTGTTTTGTTCATATGTAAACCTCGAGTGTCCGATTTCAAATTGGTCAATGGTCAAAAGTTAATAAACCCATTGCTGCGTTTATATTATCGTCGTGCTATGGTACATACATTCACAAATGTATGTAAATCTAACGCCTGTAAATTCACGAACATATGGCACGAAAAACCAAACAAGAAGCGCAAGAAACGCGCCAACACATCCTCGATGTG	CCGCCAGAGGCGTAAACCCTCTGTTTTTGTTCATATGTAAACCTCGAGTGTCCGATTTCAAATTGGTCAATGGTCAAAAGTTAATAAACCCATTGCTGCGTTTATATTATCGTCGTGCTATGGTACATACATTCACAAATGTATGTAAATCTAACGCCTGTAAATTCACGAACATATGGCACGAAAAACCAAACAAGAAGCGCAAGAAACGCGCCAACACATCCTCGATGTG
TGGTCAAAAGTTAATAAACCCATTGCTGCGGTTTATATTTATCGTCGTGCTATGGTACATACATTCACAAATGTATGTAAATCTAACGCCTGTAAATTCACGAACATATGGCACGAAAAACCAAACAAAGAAGCGCAAGAAACGCGCCAACACATCCTCGATGTGGCTCTACGTCTTTTCTCACAGCAGG	TGGTCAAAAGTTAATAAACCCATTGCTGCGTTTATATTATCGTCGTGCTATGGTACATACATTCACAAATGTATGTAAATCTAACGCCTGTAAATTCACGAACATATGGCACGAAAAACCAAACAAGAAGCGCAAGAAACGCGCCAACACATCCTCGATGTGGCTCTACGTCTTTTCTCACAGCAGG
TGTCCGATTTCAAATTGGTCAATGGTCAAAGTTAATAAACCATTGCTGCGTTTATATTATCGTCGTGCTATGGTACATACATTCACAAATGTATGTAAATCTAACGCCTGTAAATTCACGAACATATGGCACGAAAAAACCAAACAAGAAGCGCAAGAAACGCGCCAACACATCCTCGATGTGGCTCTACGTCTTTTCCTCACAGCCAGGGGGTATCATCCACCTCGCTGG	TGTCCGATTTCAAATTGGTCAATGGTCAAAAGTTAATAAACCCATTGCTGCGTTTATATTATCGTCGTGCTATGGTACATACATTCACAAATGTATGTAAATCTAACGCCTGTAAATTCACGAACATATGGCACGAAAAACCAAACAAGAAGCGCAAGAAACGCGCCAACACATCCTCGATGTGGCTCTACGTCTTTTCTCACAGCAGGGGGTATCATCCACCTCGCTGG
GATTTCAAATTGGTCAATGGTCAAAAGTTATAAACCCATTGCTGCGTTTATATTATCGTCGTGCTATGGTACAATACATTCACAAATGTATGTAAATCTAACGCCTGTAAATTCACGAACAATAATGGCACGAAAAAACCAAACCAAAGAAGACGCCAAGAAACGCGCCAACACATCCTCGAT	GATTTCAAATTGGTCAATGGTCAAAAGTTAATAAACCCATTGCTGCGTTTATATTATCGTCGTGCTATGGTACATACATTCACAAATGTATGTAAATCTAACGCCTGTAAATTCACGAACATATGGCACGAAAAACCAAACAAGAAGCGCAAGAAACGCGCCAACACATCCTCGAT
ATAAACCCATTGCTGCGTTTATATTATCGTTCGTGCTATGGTACATACATTACACAAATGTATGTAAATCTAACGCCTGTAAATTCACGAACATATGGCACGAAAAACCAAACAAAGAAGCGCAAGAAACGCGCCAACACATCCTCGATGTGGCTCTACGTCTTTTCTCACAGCA	ATAAACCCATTGCTGCGTTTATATTATCGTCGTGCTATGGTACATACATTCACAAATGTATGTAAATCTAACGCCTGTAAATTCACGAACATATGGCACGAAAAACCAAACAAGAAGCGCAAGAAACGCGCCAACACATCCTCGATGTGGCTCTACGTCTTTTCTCACAGCA
AATAAACCATTGCTGCGTTTATATTATCGTCGTGCTATGGTACATACATTCACAAATGTATGTAAAATCTAACGCCTGTAAATTCACGAACATATGGCACGAAAAACCAAACAAGAAGCGCAAGAAAACGACGCCCAACAACATCTCCGACTGTGTCTACGTCTTTTCTCACAGCAGGGGGATTCATCCACCTCGCTGGGCGAGATTGCAAAGCAGCTGGCGTTACGCGCG	AATAAACCCATTGCTGCGTTTATATTATCGTCGTGCTATGGTACATACATTCACAAATGTATGTAAATCTAACGCCTGTAAATTCACGAACATATGGCACGAAAAACCAAACAAGAAGCGCAAGAAACGCGCCAACACATCCTCGATGTGGCTCTACGTCTTTTCTCACAGCAGGGGGTATCATCCACCTCGCTGGGCGAGATTGCAAAAGCAGCTGGCGTTACGCGCG
TGGTACATACATTCACAAATGTATGTAAATATAACCGCTGTAAATTCAACAACATATGGCACGAAAAACCAAACAAGAAAGCGCAAGAAACGCGCCAACACATCCTCGATGTGGCTCTACGTCTTTTCTCACAGCAGGGGGGTATCATCCACCTCGCTGGGCGAGATTGCAAAAGCAGCTG	TGGTACATACATTCACAAATGTATGTAAATCTAACGCCTGTAAATTCACGAACATATGGCACGAAAAACCAAACAAGAAGCGCAAGAAACGCGCCAACACATCCTCGATGTGGCTCTACGTCTTTTCTCACAGCAGGGGGTATCATCCACCTCGCTGGGCGAGATTGCAAAAGCAGCTG
TTGCTGCGTTTATATTATCGTCGTGCTATGTACATACATTCACAAATGTATGTAAATCTAACGCCTGTAAATTCACGAACATATGGCACGAAAAACCAAACAAGAAGCGCAAGAAACGCGCCAACACATCCTCGATGTGGCTCTACGTCTTTTCTCACAGCAGGGGGTATCATCCACCTCGCTGGGCGAGATTGCAAAAGCAGCTGGCGTTACGCGCGGTGCAATCTACTGGCATTT	TTGCTGCGTTTATATTATCGTCGTGCTATGGTACATACATTCACAAATGTATGTAAATCTAACGCCTGTAAATTCACGAACATATGGCACGAAAAACCAAACAAGAAGCGCAAGAAACGCGCCAACACATCCTCGATGTGGCTCTACGTCTTTTCTCACAGCAGGGGGTATCATCCACCTCGCTGGGCGAGATTGCAAAAGCAGCTGGCGTTACGCGCGGTGCAATCTACTGGCATTT
AGAACGACCGCCAGAGGCGTAAACCCATCTGTTTTTGTTCATATGTAAACCTCGAGTGTCCGATTTCAAATTGGTCAATGGTCAAAAGTTAATAAACCCATTGCTGCGTTTATATTATCGTCGTGCTATGGTACATACATTCACAAATGTATGTAAATCTAACGCCTGTAAATTCACGAACATATGGCACGAAAAACCAAACAAGAAGCGCAAGAAACGCGCCAACACATCCTCGATGTGGCTC	AGAACGACCGCCAGAGGCGTAAACCCTCTGTTTTTGTTCATATGTAAACCTCGAGTGTCCGATTTCAAATTGGTCAATGGTCAAAAGTTAATAAACCCATTGCTGCGTTTATATTATCGTCGTGCTATGGTACATACATTCACAAATGTATGTAAATCTAACGCCTGTAAATTCACGAACATATGGCACGAAAAACCAAACAAGAAGCGCAAGAAACGCGCCAACACATCCTCGATGTGGCTC
TGTTCATATGTAAAACGTCGAGTGTCCGATTTTCAAATTGGTCAATGGTCAAAAGTTAATAAACCCATTGCTCGTTTATATTTATCGTCGTGCTATGGTACATACATTCACAAATGTATGTAAATCTAAACGCCTGTAAATTCACGAACATATGGCACGAAAAACCAAACAAAGAAGCGCAAGAAACGCGCCAACACATCCTCGATGTGGCTCTACGTCTTTTCTCACAGCAGGGGGG	TGTTCATATGTAAACCTCGAGTGTCCGATTTCAAATTGGTCAATGGTCAAAAGTTAATAAACCCATTGCTGCGTTTATATTATCGTCGTGCTATGGTACATACATTCACAAATGTATGTAAATCTAACGCCTGTAAATTCACGAACATATGGCACGAAAAACCAAACAAGAAGCGCAAGAAACGCGCCAACACATCCTCGATGTGGCTCTACGTCTTTTCTCACAGCAGGGGGT
CGTTTATATTATCGTCGTGCTATGGTACATTCCAATTACACAATGTAATGTAAATACACGCCTGTAAATCAACAACAGTGGCAACGAAAAACCAAACAACGAAGCAGCAAGAAACGCGCCAACACATCCTCGATGTGGCTCTACGTCTTTTCTCACAGCAGGGGGTATCATCCACCTCGCTGGGCGAGATTGCAAAAGCAGCTGGCGTTACGCGCGGTGCAATCTACTGGCATTT	CGTTTATATTATCGTCGTGCTATGGTACATACATTCACAAATGTATGTAAATCTAACGCCTGTAAATTCACGAACATATGGCACGAAAAACCAAACAAGAAGCGCAAGAAACGCGCCAACACATCCTCGATGTGGCTCTACGTCTTTTCTCACAGCAGGGGGTATCATCCACCTCGCTGGGCGAGATTGCAAAAGCAGCTGGCGTTACGCGCGGTGCAATCTACTGGCATTT
TGCCTGAGAGCATCAGAACGACGCCAGAGGCGTAACCCATCTGTTTTGTTCATATGTAAACCTCGAGTGTCCGATTTCAAATTGGTCAATGGTCAAAAGTTAATAAACCCATTGCTGCGTTTATATTATCGTCGTGCTATGGTACATACATTCACAAATGTATGTAAATCTAACGCCTGTAAATTCACGAACATATGGCACGAAAAACCAAACAAGAAGCGCAAGAAACGCGCC	TGCCTGAGAGCATCAGAACGACCGCCAGAGGCGTAAACCCTCTGTTTTTGTTCATATGTAAACCTCGAGTGTCCGATTTCAAATTGGTCAATGGTCAAAAGTTAATAAACCCATTGCTGCGTTTATATTATCGTCGTGCTATGGTACATACATTCACAAATGTATGTAAATCTAACGCCTGTAAATTCACGAACATATGGCACGAAAAACCAAACAAGAAGCGCAAGAAACGCGCC
GCTATGGTACATACATTCACAAATGTATGTTAAATACTAACGCCTGTAAATTCAACGAACATATGGCACGAAAAACCAAACAAGAAAGCGCAAGAAACAGCGCCAACACATCCTCGATGTGGCTCTACGTCTTTTCTCACAGCAGGGGGTATCATCCACCTCGCTGGGCGAGATTGCAAAAGCAGCTGGCGTTACGCGCGGTGCAATCTACTGGCATTTTAAAGACA	GCTATGGTACATACATTCACAAATGTATGTAAATCTAACGCCTGTAAATTCACGAACATATGGCACGAAAAACCAAACAAGAAGCGCAAGAAACGCGCCAACACATCCTCGATGTGGCTCTACGTCTTTTCTCACAGCAGGGGGTATCATCCACCTCGCTGGGCGAGATTGCAAAAGCAGCTGGCGTTACGCGCGGTGCAATCTACTGGCATTTTAAAGACA
AATTGGTCAATGGTCAAAAGTTAATAAACCATTGCTGCGTTTATATTATCGTCGTGCTATGGTACATACATTCACAAATGTATGTAAATCTAACGCCTGTAAATTCACGAACATATGGCACGAAAAACCAAACAAGAAGCGCAAGAAAACGCGCCAACACATCCTCGATAGTGGCTCTACGTCTTTTCTCACAGCAGGGG	AATTGGTCAATGGTCAAAAGTTAATAAACCCATTGCTGCGTTTATATTATCGTCGTGCTATGGTACATACATTCACAAATGTATGTAAATCTAACGCCTGTAAATTCACGAACATATGGCACGAAAAACCAAACAAGAAGCGCAAGAAACGCGCCAACACATCCTCGATGTGGCTCTACGTCTTTTCTCACAGCAGGGG
AATTGGTCAATGGTCAAAAGTTAATAAACCATTGCTGCGTTTATATTATCGTCGTGCTATGGTACATACATTCACAAATGTATGTAAATCTAACGCCTGTAAATTCACGAACATATGGCACGAAAAACCAAACAAGAAGCGCAAGAAACGCGCCAACACATCCTCGATGTGGCTCTACGTCTTTTCTCACAGCAGGGGGTACTCATCCACCTCGCTGGGCGAAGATTGCAAAAGCAGCTGGCGTTACGCGC	AATTGGTCAATGGTCAAAAGTTAATAAACCCATTGCTGCGTTTATATTATCGTCGTGCTATGGTACATACATTCACAAATGTATGTAAATCTAACGCCTGTAAATTCACGAACATATGGCACGAAAAACCAAACAAGAAGCGCAAGAAACGCGCCAACACATCCTCGATGTGGCTCTACGTCTTTTCTCACAGCAGGGGGTATCATCCACCTCGCTGGGCGAGATTGCAAAAGCAGCTGGCGTTACGCGC
CACGAAAAACCAAACAAGAAGCGCAAGAAAACGCGCCAAACACATCCTCGATGTGGCTCTACGTCTTTTCTCACAGCAGGGGGTATCATCCACCTCGCTGGGCGAGATTGCAAAAGCAGCTGGCGTTACGCGCGGTGCAATCTACTGGCATTTTAAAGACAAGTCGG	CACGAAAAACCAAACAAGAAGCGCAAGAAACGCGCCAACACATCCTCGATGTGGCTCTACGTCTTTTCTCACAGCAGGGGGTATCATCCACCTCGCTGGGCGAGATTGCAAAAGCAGCTGGCGTTACGCGCGGTGCAATCTACTGGCATTTTAAAGACAAGTCGG
AATTGGTCAATGGTCAAAAGTTAATAAACCATTGCTGCGTTTATATTATCGTCGTGCTATGGTACATACATTCACAAATGTATGTAAATCTAACGCCTGTAAATTCACGAACATATGGCACGAAAAAACCAAACAAGAAGCGCAAGAAAACGCGCCAACACATCCTCGAATGTGGCTCTACGTCTTTTCTCACAGCAGGGGTAGTCATCCACCTCGCTGGGCGAGATTGACAAAAGC	AATTGGTCAATGGTCAAAAGTTAATAAACCCATTGCTGCGTTTATATTATCGTCGTGCTATGGTACATACATTCACAAATGTATGTAAATCTAACGCCTGTAAATTCACGAACATATGGCACGAAAAACCAAACAAGAAGCGCAAGAAACGCGCCAACACATCCTCGATGTGGCTCTACGTCTTTTCTCACAGCAGGGGGTATCATCCACCTCGCTGGGCGAGATTGCAAAAGC
CGTGCTATGGTACATACATTCACAAATGTAATGTAATACTAACGCCTGTAAATTCAACGAACATATGGCAACGAAAAACCAAACAAGAAAGCGCAAGAAACGCGCCAACACATCCTCGATGTGGCTCTACGTCTTTTCTCACAGCAGGGGGTATCATCCACCTCGCTG	CGTGCTATGGTACATACATTCACAAATGTATGTAAATCTAACGCCTGTAAATTCACGAACATATGGCACGAAAAACCAAACAAGAAGCGCAAGAAACGCGCCAACACATCCTCGATGTGGCTCTACGTCTTTTCTCACAGCAGGGGGTATCATCCACCTCGCTG
AATTGGTCAATGGTCAAAAGTTAATAAACCATTGCTGCGTTTATATTATCGTCGTGCTATGGTACATACATTCACAAATGTATGTAAATCTAACGCCTGTAAATTCACGAACATATGGCACGAAAAACCAAACAAGAAGCGCAAGAAAACGCGCCAACACATCCTCGATGTGGCTCTACGTCTTTTCTCACAGCAGGGGGTATCATCCACCTCGCAGGGCGTAGATTACAAAAGGCAGCTGGCGTTACG	AATTGGTCAATGGTCAAAAGTTAATAAACCCATTGCTGCGTTTATATTATCGTCGTGCTATGGTACATACATTCACAAATGTATGTAAATCTAACGCCTGTAAATTCACGAACATATGGCACGAAAAACCAAACAAGAAGCGCAAGAAACGCGCCAACACATCCTCGATGTGGCTCTACGTCTTTTCTCACAGCAGGGGGTATCATCCACCTCGCTGGGCGAGATTGCAAAAGCAGCTGGCGTTACG
AATGGTCAAAAAGTTAATAAACCATTGCTGCGTTTATATTATCGTCGTGCTATGGTACATACATTCACAAATGTATGTAAATCTAACGCCTGTAAATTCACGAACATATGGCACGAAAAACCAAAACAAGAAGCGCAAGAAAACGCGCCAACACATCCTCGATGTGGCTCTACGTTCTTTTCTCACAGCAGGGGGGACTTCATCCACCATCGCTGGGCGAGATTGCAAAAGCAGCTGGCGTTACGCGCG	AATGGTCAAAAGTTAATAAACCCATTGCTGCGTTTATATTATCGTCGTGCTATGGTACATACATTCACAAATGTATGTAAATCTAACGCCTGTAAATTCACGAACATATGGCACGAAAAACCAAACAAGAAGCGCAAGAAACGCGCCAACACATCCTCGATGTGGCTCTACGTCTTTTCTCACAGCAGGGGGTATCATCCACCTCGCTGGGCGAGATTGCAAAAGCAGCTGGCGTTACGCGCG
GCTGCGTTTATATTATCGTCGTGCTATGGTTACATACATTCACAAATGTAATGTAAATCTAACGCCTGTAAATTCAACGAACATATGGCAACGAAAAACCAAACAAGAAGCAGCAAGAAACGCGCCAACACATCCTCGATGTGGCTCTACGTCTTTTCTCACAGCAGGGGGTATCATCCACCTCGCTGGGCGAGATTGCAAAAGCAGCTGGCGTTACGCGCG	GCTGCGTTTATATTATCGTCGTGCTATGGTACATACATTCACAAATGTATGTAAATCTAACGCCTGTAAATTCACGAACATATGGCACGAAAAACCAAACAAGAAGCGCAAGAAACGCGCCAACACATCCTCGATGTGGCTCTACGTCTTTTCTCACAGCAGGGGGTATCATCCACCTCGCTGGGCGAGATTGCAAAAGCAGCTGGCGTTACGCGCG
CGCCAGAGGCGTAAACCCATCTGTTTTTGTTCATATGTAAACCTCGAGTGTCCGATTTCAAATTGGTCAATGGTCAAAAGTTAATAAACCCATTGCTGCGTTTATATTATCGTCGTGCTATGGTACATACATTCACAAATGTATGTAAATCTAACGCCTGTAAATTCACGAACATATGGCACGAAAAACCAAACAAGAAGCGCAAGAAACGCGCCAACACATCCTCGATGTGG	CGCCAGAGGCGTAAACCCTCTGTTTTTGTTCATATGTAAACCTCGAGTGTCCGATTTCAAATTGGTCAATGGTCAAAAGTTAATAAACCCATTGCTGCGTTTATATTATCGTCGTGCTATGGTACATACATTCACAAATGTATGTAAATCTAACGCCTGTAAATTCACGAACATATGGCACGAAAAACCAAACAAGAAGCGCAAGAAACGCGCCAACACATCCTCGATGTGG
TGGTACATACATTCACAAATGTATGTAAATACTAACGCCTGTAATTCAACGAACATATGGCACGAAAAACCAAACAGAAAGCGCAAGAGACGCGCCAACACATCCTCGATGTGGCTCTACGTCTTTTCTCACAGCAGGGGGTATCATCCACCTCGCTGGGCGAGATTGCAAAAGCAGCTGGCGTTACGCGCGGTGC	TGGTACATACATTCACAAATGTATGTAAATCTAACGCCTGTAAATTCACGAACATATGGCACGAAAAACCAAACAAGAAGCGCAAGAAACGCGCCAACACATCCTCGATGTGGCTCTACGTCTTTTCTCACAGCAGGGGGTATCATCCACCTCGCTGGGCGAGATTGCAAAAGCAGCTGGCGTTACGCGCGGTGC
CTGTTTTTGTTCATAATGTAAACCTCGAGTGTCCGATTTCAAATTGGTCAATGGTCAAAAGTTAATAAACCCATTGCTGCGTTTATATTATCGTCGTGCTATGGTACATACATTACACAAATGTATGTAAATCTAACGCCTGTAAATTCACGAACATAATGGCACGAAAAAACCAAACAAAGAAGCGCAAGAAACGCGCCAACACATCCTCGATGTGGCTCTACGTCTTTTCTCACA	CTGTTTTTGTTCATATGTAAACCTCGAGTGTCCGATTTCAAATTGGTCAATGGTCAAAAGTTAATAAACCCATTGCTGCGTTTATATTATCGTCGTGCTATGGTACATACATTCACAAATGTATGTAAATCTAACGCCTGTAAATTCACGAACATATGGCACGAAAAACCAAACAAGAAGCGCAAGAAACGCGCCAACACATCCTCGATGTGGCTCTACGTCTTTTCTCACA
CTGTTTTTGTTCATAATGTAAACCTCGAGTGTCCGATTTCAAATTGGTCAATGGTCAAAAGTTAATAAACCCATTGCTGCGTTTATATTATCGTCGTGCTATGGTACATACATTACACAAATGTATGTAAATCTAACGCCTGTAAATTCACGAACATAATGGCACGAAAAAACCAAACAAAGAAGCGCAAGAAACGCGCCAACACATCCTCGATGTGGCTCTACGTCTTTTCTCACA	CTGTTTTTGTTCATATGTAAACCTCGAGTGTCCGATTTCAAATTGGTCAATGGTCAAAAGTTAATAAACCCATTGCTGCGTTTATATTATCGTCGTGCTATGGTACATACATTCACAAATGTATGTAAATCTAACGCCTGTAAATTCACGAACATATGGCACGAAAAACCAAACAAGAAGCGCAAGAAACGCGCCAACACATCCTCGATGTGGCTCTACGTCTTTTCTCACA
CTGTTTTTGTTCATAATGTAAACCTCGAGTGTCCGATTTCAAATTGGTCAATGGTCAAAAGTTAATAAACCCATTGCTGCGTTTATATTATCGTCGTGCTATGGTACATACATTACACAAATGTATGTAAATCTAACGCCTGTAAATTCACGAACATAATGGCACGAAAAAACCAAACAAAGAAGCGCAAGAAACGCGCCAACACATCCTCGATGTGGCTCTACGTCTTTTCTCACA	CTGTTTTTGTTCATATGTAAACCTCGAGTGTCCGATTTCAAATTGGTCAATGGTCAAAAGTTAATAAACCCATTGCTGCGTTTATATTATCGTCGTGCTATGGTACATACATTCACAAATGTATGTAAATCTAACGCCTGTAAATTCACGAACATATGGCACGAAAAACCAAACAAGAAGCGCAAGAAACGCGCCAACACATCCTCGATGTGGCTCTACGTCTTTTCTCACA
TTGCTGCGTTTATATTATCGTCGTGCTATGTACATACATTACACAAATGTATGTAAATCTAACGCCTGTAAATTCACGAACATATGGCACGAAAAACCAAACAAGAAGCGCAAGAAACGCGCCAACACATCCTCGATGTGGCTCTACGTCTTTTCTCACAGCAGGGGGTATCATCCACCTCGCTGGGCGAGATTGCAAAAGCAGCTGGCGTTACGCGCGGTGCAATCTACTGGCATTTTAAAG	TTGCTGCGTTTATATTATCGTCGTGCTATGGTACATACATTCACAAATGTATGTAAATCTAACGCCTGTAAATTCACGAACATATGGCACGAAAAACCAAACAAGAAGCGCAAGAAACGCGCCAACACATCCTCGATGTGGCTCTACGTCTTTTCTCACAGCAGGGGGTATCATCCACCTCGCTGGGCGAGATTGCAAAAGCAGCTGGCGTTACGCGCGGTGCAATCTACTGGCATTTTAAAG
AATGGTCAAAAGTTAATAAACCATTGCTGCGTTTATATTATCGTCGTGCTATGGTACATACATTCACAAATGTATGTAAATCTAACGCCTGTAAATTCACGAACATATGGCACGAAAAACCAAACAAGAAGCGCAAGAAAACGCGCCAACACATCCTCGAATGTGGCTCTACGTCTTTTCTCACAGCAGGGGGTATCATCCACCTCGCTGGGCGAGATTGCAAAAGGCAGCTGGCGTTACG	AATGGTCAAAAGTTAATAAACCCATTGCTGCGTTTATATTATCGTCGTGCTATGGTACATACATTCACAAATGTATGTAAATCTAACGCCTGTAAATTCACGAACATATGGCACGAAAAACCAAACAAGAAGCGCAAGAAACGCGCCAACACATCCTCGATGTGGCTCTACGTCTTTTCTCACAGCAGGGGGTATCATCCACCTCGCTGGGCGAGATTGCAAAAGCAGCTGGCGTTACG
CGTTTATATTATCGTCGTGCTATGGTACATTCCAATTACACAATGTAATGTAAATACACGCCTGTAAATCAACAACAGTGGCAACGAAAAACCAAACAACGAAGCAGCAAGAAACGCGCCAACACATCCTCGATGTGGCTCTACGTCTTTTCTCACAGCAGGGGGTATCATCCACCTCGCTGGGCGAGATTGCAAAAGCAGCTGGCGTTACGCGCGGTGCAATCTACTGGCATTT	CGTTTATATTATCGTCGTGCTATGGTACATACATTCACAAATGTATGTAAATCTAACGCCTGTAAATTCACGAACATATGGCACGAAAAACCAAACAAGAAGCGCAAGAAACGCGCCAACACATCCTCGATGTGGCTCTACGTCTTTTCTCACAGCAGGGGGTATCATCCACCTCGCTGGGCGAGATTGCAAAAGCAGCTGGCGTTACGCGCGGTGCAATCTACTGGCATTT
TAAACCTCGAGTGTCCGAATTTCAAATTGGTCAATGGTCAAAAGTTAATAAACCCATTGCTGCGTTTATATTATCGTCGTGCTATGGTACATACATTCACAATGTAATGTAAATACTAACGCCTGTAAATTCAACGAACATATGCACGAAAAACCAAACAAAGAAGCGCAAGAAAACGCGCCAACACATCCTCGATGTGGCTCTACGTCTTTTCTCACAGCAGGGGGGT	TAAACCTCGAGTGTCCGATTTCAAATTGGTCAATGGTCAAAAGTTAATAAACCCATTGCTGCGTTTATATTATCGTCGTGCTATGGTACATACATTCACAAATGTATGTAAATCTAACGCCTGTAAATTCACGAACATATGGCACGAAAAACCAAACAAGAAGCGCAAGAAACGCGCCAACACATCCTCGATGTGGCTCTACGTCTTTTCTCACAGCAGGGGGTA
AACCCATTGCTGCGTTATATTATCGTCGTGCTATGGTACATTCACTCACAATGTAATGTAATACACGCTGTAAATCAACAACAGTGGCAACGAAAAACCAAACAACGAAGCAGCAAGAAACGCGCCAACACATCCTCGATGTGGCTCTACGTCTTTCTCACAGCAGGGGGTATCATCCACCTCGCTGGGCGAGATTGCAAAAGCAGCTGGCGTTACGCGCGGTGCAATCTACTGGCATTTTAAAG	AACCCATTGCTGCGTTTATATTATCGTCGTGCTATGGTACATACATTCACAAATGTATGTAAATCTAACGCCTGTAAATTCACGAACATATGGCACGAAAAACCAAACAAGAAGCGCAAGAAACGCGCCAACACATCCTCGATGTGGCTCTACGTCTTTTCTCACAGCAGGGGGTATCATCCACCTCGCTGGGCGAGATTGCAAAAGCAGCTGGCGTTACGCGCGGTGCAATCTACTGGCATTTTAAAG
GTAAATCTAACGCCTGTAAATTCACGAACAGTATGGACACGAAAAACCAAACAAGAAGCGCAAGAAACGCGCCAACACATCCTCGAATGGTGCCTCTTACGTCTTTTCTCACAGCAGGGGGACTCATCCACCTCGCTGGGCGAGATTGCAAAAGCA	GTAAATCTAACGCCTGTAAATTCACGAACATATGGCACGAAAAACCAAACAAGAAGCGCAAGAAACGCGCCAACACATCCTCGATGTGGCTCTACGTCTTTTCTCACAGCAGGGGGTATCATCCACCTCGCTGGGCGAGATTGCAAAAGCA
TTGCTGCGTTTATATTATCGTCGTGCTATGTACATACATTCACAAATGTATGTAAATCTAACGCCTGTAAATTCACGAACATATGGCACGAAAAACCAAACAAGAAGCGCAAGAAACGCGCCAACACATCCTCGATGTGGCTCTACGTCTTTTCTCACAGCAGGGGGTATCATCCACCTCGCTGGGCGAGATTGCAAAAGCAGCTGGCGTTACGCGCGGTGCAATCTACTGGCATTTTAAAG	TTGCTGCGTTTATATTATCGTCGTGCTATGGTACATACATTCACAAATGTATGTAAATCTAACGCCTGTAAATTCACGAACATATGGCACGAAAAACCAAACAAGAAGCGCAAGAAACGCGCCAACACATCCTCGATGTGGCTCTACGTCTTTTCTCACAGCAGGGGGTATCATCCACCTCGCTGGGCGAGATTGCAAAAGCAGCTGGCGTTACGCGCGGTGCAATCTACTGGCATTTTAAAG
ATGTAAATCTAACGCCTGTAAATTCACGAAACATATGGCACGAAAAACCAAACAAGAAGCGCAAGAAACGCGCCAACACATCCTCGATGTGGCTCTACGTCTTTTCTCACAGCAGGGGGTATCATCCACCTCGCTGGGCGAGATTGCAAAAGCAGCTGGCGTTACGCGCGGTGCAATCT	ATGTAAATCTAACGCCTGTAAATTCACGAACATATGGCACGAAAAACCAAACAAGAAGCGCAAGAAACGCGCCAACACATCCTCGATGTGGCTCTACGTCTTTTCTCACAGCAGGGGGTATCATCCACCTCGCTGGGCGAGATTGCAAAAGCAGCTGGCGTTACGCGCGGTGCAATCT
CACGAAAAACCAAACAAGAAGCGCAAGAAAACGCGCCAACACATCCTCGATGTGGCTCTACGTCTTTTCTCACAGCAGGGGGTATCATCCACCTCGCAGGGCGTAGATTGCAAAAGCAGCTGGCGTTACGCGCGGTGCAATCTACTGGCATTT	CACGAAAAACCAAACAAGAAGCGCAAGAAACGCGCCAACACATCCTCGATGTGGCTCTACGTCTTTTCTCACAGCAGGGGGTATCATCCACCTCGCTGGGCGAGATTGCAAAAGCAGCTGGCGTTACGCGCGGTGCAATCTACTGGCATTT
AATTGGTCAATGGTCAAAAGTTAATAAACCATTGCTGCGTTTATATTATCGTCGTGCTATGGTACATACATTCACAAATGTATGTAAATCTAACGCCTGTAAATTCACGAACATATGGCACGAAAAACCAAACAAGAAGCGCAAGAAACGCGCCAACACATCCTCGATGTGGCTCTACGTCTTTTCTCACAGCAGGGGGTACTCATCCACCTCGCTGGGCGAAGATTGCAAAAGCAGCTGGCGTTACGCGC	AATTGGTCAATGGTCAAAAGTTAATAAACCCATTGCTGCGTTTATATTATCGTCGTGCTATGGTACATACATTCACAAATGTATGTAAATCTAACGCCTGTAAATTCACGAACATATGGCACGAAAAACCAAACAAGAAGCGCAAGAAACGCGCCAACACATCCTCGATGTGGCTCTACGTCTTTTCTCACAGCAGGGGGTATCATCCACCTCGCTGGGCGAGATTGCAAAAGCAGCTGGCGTTACGCGC
TTGCTGCGTTTATATTATCGTCGTGCTATGTACATACATTCACAAATGTATGTAAATCTAACGCCTGTAAATTCACGAACATATGGCACGAAAAACCAAACAAGAAGCGCAAGAAACGCGCCAACACATCCTCGATGTGGCTCTACGTCTTTTCTCACAGCAGGGGGTATCATCCACCTCGCTGGGCGAGATTGCAAAAGCAGCTGGCGTTACGCGCGGTGCAATCTACTGGCATTTTAAAG	TTGCTGCGTTTATATTATCGTCGTGCTATGGTACATACATTCACAAATGTATGTAAATCTAACGCCTGTAAATTCACGAACATATGGCACGAAAAACCAAACAAGAAGCGCAAGAAACGCGCCAACACATCCTCGATGTGGCTCTACGTCTTTTCTCACAGCAGGGGGTATCATCCACCTCGCTGGGCGAGATTGCAAAAGCAGCTGGCGTTACGCGCGGTGCAATCTACTGGCATTTTAAAG
CCGCCAGAGGCGTAAACCCTCTGTTTTGTTCATATGTAAACCTCGAGTGTCCGATTTCAAATTGGTCAATGGTCAAAAGTTAATAAACCCATTGCTGCGTTTATATTATCGTCGTGCTATGGTACATACATTCACAAATGTATGTAAATCTAACGCCTGTAAATTCACGAACATATGGCACGAAAAACCAAACAAGAAGCGCAAGAAACGCGCCAACACATCCTCGATGTG	CCGCCAGAGGCGTAAACCCTCTGTTTTTGTTCATATGTAAACCTCGAGTGTCCGATTTCAAATTGGTCAATGGTCAAAAGTTAATAAACCCATTGCTGCGTTTATATTATCGTCGTGCTATGGTACATACATTCACAAATGTATGTAAATCTAACGCCTGTAAATTCACGAACATATGGCACGAAAAACCAAACAAGAAGCGCAAGAAACGCGCCAACACATCCTCGATGTG
GCTATGGTACATACATTCACAAATGTATGTTAAATACTAACGCCTGTAAATTCAACGAACATATGGCACGAAAAACCAAACAAGAAAGCGCAAGAAACAGCGCCAACACATCCTCGATGTGGCTCTACGTCTTTTCTCACAGCAGGGGGTATCATCCACCTCGCTGGGCGAGATTGCAAAAGCAGCTGGCGTTACGCGCGGTGCAATCTACTGGCATTTTAAAGACA	GCTATGGTACATACATTCACAAATGTATGTAAATCTAACGCCTGTAAATTCACGAACATATGGCACGAAAAACCAAACAAGAAGCGCAAGAAACGCGCCAACACATCCTCGATGTGGCTCTACGTCTTTTCTCACAGCAGGGGGTATCATCCACCTCGCTGGGCGAGATTGCAAAAGCAGCTGGCGTTACGCGCGGTGCAATCTACTGGCATTTTAAAGACA
ATTCACGAACATATGGCACGAAAAACCAAAACAAGAAGCGCAAGAAAACGCGCCAACACATCCTCCGATGTGGCTCTACGTCTTTTCTCACAGCAGGGGGTAGTCATCCACCTCGCTGGGCGAGATTGCAAAAGCAGCTGGCGTTACGCGCGGTGCAATCTACTGGCATTTTAA	ATTCACGAACATATGGCACGAAAAACCAAACAAGAAGCGCAAGAAACGCGCCAACACATCCTCGATGTGGCTCTACGTCTTTTCTCACAGCAGGGGGTATCATCCACCTCGCTGGGCGAGATTGCAAAAGCAGCTGGCGTTACGCGCGGTGCAATCTACTGGCATTTTAA
CGTAAACCCACTGTTTTTGTTCATATGTAAATCCTCGAGTGTCCGATTTCAAATTGGTCAATGGTCAAAAGTTAATAAACCCATTGCTGCGTTTATATTATCGTCGTGCTATGGTACATACATTCACAAATGTATGTAAATCTAACGCCTGTAAATTCACGAACATATGGCACGAAAAACCAAACAAGAAGCGCAAGAAACGCGCCAACACATCCTCGATGTGGCTCTACGTCTTTTCTCA	CGTAAACCCTCTGTTTTTGTTCATATGTAAACCTCGAGTGTCCGATTTCAAATTGGTCAATGGTCAAAAGTTAATAAACCCATTGCTGCGTTTATATTATCGTCGTGCTATGGTACATACATTCACAAATGTATGTAAATCTAACGCCTGTAAATTCACGAACATATGGCACGAAAAACCAAACAAGAAGCGCAAGAAACGCGCCAACACATCCTCGATGTGGCTCTACGTCTTTTCTCA
TGGTACATACATTCACAAATGTATGTAAATACTAACGCCTGTAATTCAACGAACATATGGCACGAAAAACCAAACAGAAAGCGCAAGAGACGCGCCAACACATCCTCGATGTGGCTCTACGTCTTTTCTCACAGCAGGGGGTATCATCCACCTCGCTGGGCGAGATTGCAAAAGCAGCTGGCGTTACGCGCGGTGC	TGGTACATACATTCACAAATGTATGTAAATCTAACGCCTGTAAATTCACGAACATATGGCACGAAAAACCAAACAAGAAGCGCAAGAAACGCGCCAACACATCCTCGATGTGGCTCTACGTCTTTTCTCACAGCAGGGGGTATCATCCACCTCGCTGGGCGAGATTGCAAAAGCAGCTGGCGTTACGCGCGGTGC
AATTGGTCAATGGTCAAAAGTTAATAAACCATTGCTGCGTTTATATTATCGTCGTGCTATGGTACATACATTCACAAATGTATGTAAATCTAACGCCTGTAAATTCACGAACATATGGACACGAAAAACCAAACAAGAAGCGCAAGAAAACGCGCCAACACATCCATCGATGTGGCTC	AATTGGTCAATGGTCAAAAGTTAATAAACCCATTGCTGCGTTTATATTATCGTCGTGCTATGGTACATACATTCACAAATGTATGTAAATCTAACGCCTGTAAATTCACGAACATATGGCACGAAAAACCAAACAAGAAGCGCAAGAAACGCGCCAACACATCCTCGATGTGGCTC
TGTTCATATGTAAAACGTCGAGTGTCCGATTTTCAAATTGGTCAATGGTCAAAAGTTAATAAACCCATTGCTCGTTTATATTTATCGTCGTGCTATGGTACATACATTCACAAATGTATGTAAATCTAAACGCCTGTAAATTCACGAACATATGGCACGAAAAACCAAACAAAGAAGCGCAAGAAACGCGCCAACACATCCTCGATGTGGCTCTACGTCTTTTCTCACAGCAGGGGGG	TGTTCATATGTAAACCTCGAGTGTCCGATTTCAAATTGGTCAATGGTCAAAAGTTAATAAACCCATTGCTGCGTTTATATTATCGTCGTGCTATGGTACATACATTCACAAATGTATGTAAATCTAACGCCTGTAAATTCACGAACATATGGCACGAAAAACCAAACAAGAAGCGCAAGAAACGCGCCAACACATCCTCGATGTGGCTCTACGTCTTTTCTCACAGCAGGGGGT
AATTGGTCAATGGTCAAAAGTTAATAAACCATTGCTGCGTTTATATTATCGTCGTGCTATGGTACATACATTCACAAATGTATGTAAATCTAACGCCTGTAAATTCACGAACATATGGCACGAAAAACCAAACAAGAAGCGCAAGAAAACGCGCCAACACATCCTCGATGTGGCTCTACGTCTTTTCTCACAGCAGGGGGTATCATCCACCTCGCAGGGCGTAGATTACAAAAGGCAGCTGGCGTTACG	AATTGGTCAATGGTCAAAAGTTAATAAACCCATTGCTGCGTTTATATTATCGTCGTGCTATGGTACATACATTCACAAATGTATGTAAATCTAACGCCTGTAAATTCACGAACATATGGCACGAAAAACCAAACAAGAAGCGCAAGAAACGCGCCAACACATCCTCGATGTGGCTCTACGTCTTTTCTCACAGCAGGGGGTATCATCCACCTCGCTGGGCGAGATTGCAAAAGCAGCTGGCGTTACG
AATTGGTCAATGGTCAAAAGTTAATAAACCATTGCTGCGTTTATATTATCGTCGTGCTATGGTACATACATTCACAAATGTATGTAAATCTAACGCCTGTAAATTCACGAACATATGGCACGAAAAAACCAAACAAGAAGCGCAAGAAAACGCGCCAACACATCCTCGAATGTGGCTCTACGTCTTTTCTCACAGCAGGGGTAGTCATCCACCTCGCTGGGCGAGATTGACAAAAGC	AATTGGTCAATGGTCAAAAGTTAATAAACCCATTGCTGCGTTTATATTATCGTCGTGCTATGGTACATACATTCACAAATGTATGTAAATCTAACGCCTGTAAATTCACGAACATATGGCACGAAAAACCAAACAAGAAGCGCAAGAAACGCGCCAACACATCCTCGATGTGGCTCTACGTCTTTTCTCACAGCAGGGGGTATCATCCACCTCGCTGGGCGAGATTGCAAAAGC
CACAAATGTATGTAAATCTAACGCCTGTAATTCAACGAACATATGGCACGAAAAACCAAACAAGAAGCGCAAGAAACGCGCCAACACATCCTCGATGTGGCTCTACGTCTTTTCTCACAGCAGGGGGTATCATCCACCTCGCTGGGCGAGATTGCAAAAGCAGCTG	CACAAATGTATGTAAATCTAACGCCTGTAAATTCACGAACATATGGCACGAAAAACCAAACAAGAAGCGCAAGAAACGCGCCAACACATCCTCGATGTGGCTCTACGTCTTTTCTCACAGCAGGGGGTATCATCCACCTCGCTGGGCGAGATTGCAAAAGCAGCTG
CTGTTTTTGTTCATATGTAAATCCTCGAGTGTCCGATTTCAAATTGGTCAATGGTCAAAAGTTAATAAACCCATTGCTGCGTTTATATTATCGTCGTGCTATGGTACATACATTCACAAATGTATGTAAATCTAACGCCTGTAAATTCACGAACATATGGCACGAAAAACCAAACAAGAAGCGCAAGAAACGCGCCAACACATCCTCGATGTGGCTCTACGTCTTTTCTCACA	CTGTTTTTGTTCATATGTAAACCTCGAGTGTCCGATTTCAAATTGGTCAATGGTCAAAAGTTAATAAACCCATTGCTGCGTTTATATTATCGTCGTGCTATGGTACATACATTCACAAATGTATGTAAATCTAACGCCTGTAAATTCACGAACATATGGCACGAAAAACCAAACAAGAAGCGCAAGAAACGCGCCAACACATCCTCGATGTGGCTCTACGTCTTTTCTCACA
CTGTTTTTGTTCATATGTAAATCCTCGAGTGTCCGATTTCAAATTGGTCAATGGTCAAAAGTTAATAAACCCATTGCTGCGTTTATATTATCGTCGTGCTATGGTACATACATTCACAAATGTATGTAAATCTAACGCCTGTAAATTCACGAACATATGGCACGAAAAACCAAACAAGAAGCGCAAGAAACGCGCCAACACATCCTCGATGTGGCTCTACGTCTTTTCTCACA	CTGTTTTTGTTCATATGTAAACCTCGAGTGTCCGATTTCAAATTGGTCAATGGTCAAAAGTTAATAAACCCATTGCTGCGTTTATATTATCGTCGTGCTATGGTACATACATTCACAAATGTATGTAAATCTAACGCCTGTAAATTCACGAACATATGGCACGAAAAACCAAACAAGAAGCGCAAGAAACGCGCCAACACATCCTCGATGTGGCTCTACGTCTTTTCTCACA
TGCCTGAGACGCATCAGAACGACCGCCAGAGGCGTAAACCCTCTGTTTTTGTTCATATGTAAACCTCGAGTGTCCGATTTCAAAATTGGGTCAATGGTCAAAAAGTTTAATAAACCCATTGCTTCGTTTATATTAATCGTTCGTGCTATGGTACATACATTCACAAATGTATGTAAATCTAACGCCTGTAAATTCACGAACATATGGCACGAAAAAACCAAACAAGAAGCGCAAGAAACGCGCCAACAC	TGCCTGAGAGCATCAGAACGACCGCCAGAGGCGTAAACCCTCTGTTTTTGTTCATATGTAAACCTCGAGTGTCCGATTTCAAATTGGTCAATGGTCAAAAGTTAATAAACCCATTGCTGCGTTTATATTATCGTCGTGCTATGGTACATACATTCACAAATGTATGTAAATCTAACGCCTGTAAATTCACGAACATATGGCACGAAAAACCAAACAAGAAGCGCAAGAAACGCGCCAACAC
CGTAAACCCACTGTTTTTGTTCATATGTAAATCCTCGAGTGTCCGATTTCAAATTGGTCAATGGTCAAAAGTTAATAAACCCATTGCTGCGTTTATATTATCGTCGTGCTATGGTACATACATTCACAAATGTATGTAAATCTAACGCCTGTAAATTCACGAACATATGGCACGAAAAACCAAACAAGAAGCGCAAGAAACGCGCCAACACATCCTCGATGTGGCTCTACGTCTTTTCTCA	CGTAAACCCTCTGTTTTTGTTCATATGTAAACCTCGAGTGTCCGATTTCAAATTGGTCAATGGTCAAAAGTTAATAAACCCATTGCTGCGTTTATATTATCGTCGTGCTATGGTACATACATTCACAAATGTATGTAAATCTAACGCCTGTAAATTCACGAACATATGGCACGAAAAACCAAACAAGAAGCGCAAGAAACGCGCCAACACATCCTCGATGTGGCTCTACGTCTTTTCTCA
TATGGTACATACATTCACAAATGTATGTAATACTACGACTCGTAAATTCACGAACATATGGCACGAAAAAACCAACAAGAAGCGCAAAGAAACGCGCCAAACACATCCTCGATGTGCTCTACGTTCTTTCTCACAGCAGGGGGTATCATCACCTCGCTGGGCGAGATTGCAAAAGCAGCTGGCGTTACGCGCGTGCAATTCTACTGGCATTTAAAGACAAGT	TATGGTACATACATTCACAAATGTATGTAAATCTAACGCCTGTAAATTCACGAACATATGGCACGAAAAACCAAACAAGAAGCGCAAGAAACGCGCCAACACATCCTCGATGTGGCTCTACGTCTTTTCTCACAGCAGGGGGTATCATCCACCTCGCTGGGCGAGATTGCAAAAGCAGCTGGCGTTACGCGCGGTGCAATCTACTGGCATTTTAAAGACAAGT
TGTTTTTTGTTCATATGTAAACCTCGAGTGTCCGATTTCAAATTGGTCAATGGTCAAAAGTTAATAAACCCATTGCTGCGTTTATATTATCGTCGTGCTATGGTACATACATTCACAAATGTATGTAAATCTAACGCCTGTAAATTCACGAACATATGGCACGAAAAACCAAACAAGAAGCGCAAGAAAACGCGCCAAACACATCCTCGAATGTGGCTCTACGTCTTTTCTCACAGCAGGGGGTATCATCCACCTCGCTGG	TGTTTTTGTTCATATGTAAACCTCGAGTGTCCGATTTCAAATTGGTCAATGGTCAAAAGTTAATAAACCCATTGCTGCGTTTATATTATCGTCGTGCTATGGTACATACATTCACAAATGTATGTAAATCTAACGCCTGTAAATTCACGAACATATGGCACGAAAAACCAAACAAGAAGCGCAAGAAACGCGCCAACACATCCTCGATGTGGCTCTACGTCTTTTCTCACAGCAGGGGGTATCATCCACCTCGCTGG
CATTGCTGCGTTTATATTATCGTCAGTGCTATGGTACATACATTCACAAATGTATGTAAATCTAACGCCTGTAAATTCACGAACATATGGCACGAAAAACCAAACAAGAAGCGCAAGAAACGCGCCAACACATCCTCGATGTGGCTCTACGTCTTTTCTCACAGCAGGGGGTATCATCCACCTCGCTGGGCGAGATTGCAAAAGCAGCTGGCGTTACGCGCGGTGCAATCTACTGGCATTTTAAAGACAAGTCGGATTTGTT	CATTGCTGCGTTTATATTATCGTCGTGCTATGGTACATACATTCACAAATGTATGTAAATCTAACGCCTGTAAATTCACGAACATATGGCACGAAAAACCAAACAAGAAGCGCAAGAAACGCGCCAACACATCCTCGATGTGGCTCTACGTCTTTTCTCACAGCAGGGGGTATCATCCACCTCGCTGGGCGAGATTGCAAAAGCAGCTGGCGTTACGCGCGGTGCAATCTACTGGCATTTTAAAGACAAGTCGGATTTGTT
CACGAAAAACCAAACAAGAAGCGCAAGAAAACGCGCCAAACACATCCTCGAATGTGGCTCTACGTCTTTTCTCACAGCAGGGGGTACTCATCCACCTCGCTGGGCGAGATTGCAAAAGCAGCTGGCGTTACGCGCGGTGCAATCTACGTGGCATTTTAAAG	CACGAAAAACCAAACAAGAAGCGCAAGAAACGCGCCAACACATCCTCGATGTGGCTCTACGTCTTTTCTCACAGCAGGGGGTATCATCCACCTCGCTGGGCGAGATTGCAAAAGCAGCTGGCGTTACGCGCGGTGCAATCTACTGGCATTTTAAAG
ATATTATCGTCGTGCTATGGTACATACATTACACAAATGTATGTAAATCTAACGCCTGTAAATTCACGAACATATGGCACGAAAAACCAAACAAGAAGCGCAAGAAACGCGCCAACACATCCTCGATGTGGCTCTACGTCTTTTCTCACAGCAGGGGGTATCATCCACCTCGCTGGGCGAGATTGCAAAAGCAGCTGGCGTTACG	ATATTATCGTCGTGCTATGGTACATACATTCACAAATGTATGTAAATCTAACGCCTGTAAATTCACGAACATATGGCACGAAAAACCAAACAAGAAGCGCAAGAAACGCGCCAACACATCCTCGATGTGGCTCTACGTCTTTTCTCACAGCAGGGGGTATCATCCACCTCGCTGGGCGAGATTGCAAAAGCAGCTGGCGTTACG
CACGAAAAACCAAACAAGAAGCGCAAGAAAACGCGCCAAACACATCCTCGATGTGGCTCTACGTCTTTTCTCACAGCAGGGGGTATCATCCACCTCGCTGGGCGAGATTGCAAAAGCAGCTGGCGTTACGCGCGGTGCAATCTACTGGCATTTTAAAGACAAGTCGG	CACGAAAAACCAAACAAGAAGCGCAAGAAACGCGCCAACACATCCTCGATGTGGCTCTACGTCTTTTCTCACAGCAGGGGGTATCATCCACCTCGCTGGGCGAGATTGCAAAAGCAGCTGGCGTTACGCGCGGTGCAATCTACTGGCATTTTAAAGACAAGTCGG
CGTTTATATTATCGTCGTGCTATGGTACATTCCAATTACACAATGTAATGTAAATACACGCCTGTAAATCAACAACAGTGGCAACGAAAAACCAAACAACGAAGCAGCAAGAAACGCGCCAACACATCCTCGATGTGGCTCTACGTCTTTTCTCACAGCAGGGGGTATCATCCACCTCGCTGGGCGAGATTGCAAAAGCAGCTGGCGTTACGCGCGGTGCAATCTACTGGCATTT	CGTTTATATTATCGTCGTGCTATGGTACATACATTCACAAATGTATGTAAATCTAACGCCTGTAAATTCACGAACATATGGCACGAAAAACCAAACAAGAAGCGCAAGAAACGCGCCAACACATCCTCGATGTGGCTCTACGTCTTTTCTCACAGCAGGGGGTATCATCCACCTCGCTGGGCGAGATTGCAAAAGCAGCTGGCGTTACGCGCGGTGCAATCTACTGGCATTT
AATTGGTCAATGGTCAAAAGTTAATAAACCATTGCTGCGTTTATATTATCGTCGTGCTATGGTACATACATTCACAAATGTATGTAAATCTAACGCCTGTAAATTCACGAACATATGGCACGAAAAAACCAAACAAGAAGCGCAAGAAAACGCGCCAACACATCCTCGAATGTGGCTCTACGTCTTTTCTCACAGCAGGGGTAGTCATCCACCTCGCTGGGCGAGATTGACAAAAGC	AATTGGTCAATGGTCAAAAGTTAATAAACCCATTGCTGCGTTTATATTATCGTCGTGCTATGGTACATACATTCACAAATGTATGTAAATCTAACGCCTGTAAATTCACGAACATATGGCACGAAAAACCAAACAAGAAGCGCAAGAAACGCGCCAACACATCCTCGATGTGGCTCTACGTCTTTTCTCACAGCAGGGGGTATCATCCACCTCGCTGGGCGAGATTGCAAAAGC
TTGCTGCGTTTATATTATCGTCGTGCTATGTACATACATTACACAAATGTATGTAAATCTAACGCCTGTAAATTCACGAACATATGGCACGAAAAACCAAACAAGAAGCGCAAGAAACGCGCCAACACATCCTCGATGTGGCTCTACGTCTTTTCTCACAGCAGGGGGTATCATCCACCTCGCTGGGCGAGATTGCAAAAGCAGCTGGCGTTACGCGCGGTGCAATCTACTGGCATTTTAAAG	TTGCTGCGTTTATATTATCGTCGTGCTATGGTACATACATTCACAAATGTATGTAAATCTAACGCCTGTAAATTCACGAACATATGGCACGAAAAACCAAACAAGAAGCGCAAGAAACGCGCCAACACATCCTCGATGTGGCTCTACGTCTTTTCTCACAGCAGGGGGTATCATCCACCTCGCTGGGCGAGATTGCAAAAGCAGCTGGCGTTACGCGCGGTGCAATCTACTGGCATTTTAAAG
TTAATAAACCCATTGCTGCGTTTATATTATTCGTCGTGCTATGGTACATACAATTCACAAATGTATGTAAAATCTAACGCCTGTAAATTCACGAAACATATGGCACGAAAAAACCAAACAAGAAGCGCAAGAAAACGCGCCAACACATCCTCGATGTGGCTCTACGTCTTTTCTCACAGCAGGGGGGTATCATCCACCTCGCTGGGCGAGATTGCAAAAGCAGCTGGCGTTACG	TTAATAAACCCATTGCTGCGTTTATATTATCGTCGTGCTATGGTACATACATTCACAAATGTATGTAAATCTAACGCCTGTAAATTCACGAACATATGGCACGAAAAACCAAACAAGAAGCGCAAGAAACGCGCCAACACATCCTCGATGTGGCTCTACGTCTTTTCTCACAGCAGGGGGTATCATCCACCTCGCTGGGCGAGATTGCAAAAGCAGCTGGCGTTACG
